overly - надмірно - чрезмерно;
preservative - консервант - консервант;
to loom - вимальовуватися - вырисовываться;
to lurk - ховатися - скрываться;
desperate - відчайдушний - отчаянный;
to convince - переконувати - убеждать;
to swell up - спухнути - опухнуть;
to bloat - роздуватися - раздуваться;
ripe - стиглий - спелый;
to darn - штопати - штопать;
to conceive - задумувати - задумывать;
to flatter - лестити - льстить;
to amuse - розважати - развлекать;
eloquently - красномовно - красноречиво;
to bestow - дарувати - дарить;
to avow - зізнатися - признаться;
mistress - господиня - хозяйка;
incumbent - необхідно - необходимо;
agreeable - приємний - приятный;
to despair - зневіритися - отчаиваться;
to oblige - зобов'язувати - обязать;
infancy - дитинство - младенчество;
to bequeath - заповідати - завещать;
cruel - жорстокий - жестокий;
to contradict - суперечити - противоречить;
immense - безмірний - необъятный;
to abandon - відмовлятися - отказаться;
to enhance - покращити - улучшить;
mundane - буденний - обычный;
to stem - запобігти - предотвратить;
to embarrass - бентежити - смущать;
to aspire - прагнути - стремиться;
henceforth - відтепер - впредь;
rapture - захоплення - восторг;
compassion - співчуття - сострадание;
vague - невизначений - смутный;
to persuade - переконувати - уговаривать;
matrimony - шлюб - брак;
vanity - пихатість - тщеславие;
sprain - розтягнення - растяжение;
medieval - середньовічний - средневековье;
to admit - визнавати - признать;
to deem - вважати - судить;
to fling - кидати - бросить;
to twitch - смикатися - дергаться;
intermediary - посередник - посредник;
orifice - отвір - отверстие;
to balloon out - роздуватися - раздуваться;
neat - акуратний - аккуратный;
discrepancy - невідповідність - несоответствие;
conformity - відповідність - соответствие;
intimate - близький - тесный;
stiffness - жорсткість - жосткость;
to swing - розмахувати - размахивать;
residual - залишковий - остаточный;
to confine - обмежувати - ограничивать;

